1111111111111
1P00E00C00001
1111111111111
